지역,재가노인복지시설_소계,노인보호전문기관_소계,노인여가복지시설_소계,노인일자리지원기관_소계,총 합계
경기,967,4,63,20,1054
전남,380,2,29,8,419
제주,56,2,2,2,62
서울,840,3,85,16,944
대구,150,2,18,8,178
충북,118,2,19,11,150
세종,14,0,0,1,15
경남,304,2,19,20,345
인천,256,2,23,11,292
경북,237,3,19,13,272
강원,330,3,16,13,362
광주,286,1,9,5,301
대전,201,1,7,5,214
울산,73,1,13,6,93
충남,222,2,16,13,253
부산,270,2,32,16,320
전북,335,2,21,16,374
